1111111
1E00C01
10010P1
10C1C01
1111111