1111111
1E00001
11100P1
11C00C1
1111111