111111111111111111111111111111111111111
10E10000000C1000110010000000C1000110011
100010000001000011000100000010000110001
101000000000000000010000000000000000101
10C1000000000100110C1000000000100110C11
1110000000000C1011000000000000C10111101
1000000C0000010011000000C00000100110001
1000000C0000010011000000C00000100110001
1000000C0000010011000000CP0000100110001
1000000C0000010011000000C00000100110001
1000000C0000010011000000C00000100110001
1000000C0000010011000000C00000100110001
1000000C0000010011000000C00000100110001
111111111111111111111111111111111111111