11111111111111111
10001000000C00001
100E0000000000001
100100000000P0001
10C00000000000001
1111000000000C001
1000000C000000001
11111111111111111