111111111111111111111111111111111111111111111
10E10000000C1000110010000000C1000110010000001
100010000001000011000100000010000110001000001
101000000000000000010000000000000000100000001
10C1000000000100110C1000000000100110C10000001
1110000000000C1011000000000000C10111100000001
1000000C0000010011000000C0000010011000000C001
1000000C0000010011000000C0000010011000000C001
1000000C0000010011000000CP000010011000000C001
1000000C0000010011000000C0000010011000000C001
1000000C0000010011000000C0000010011000000C001
1000000C0000010011000000C0000010011000000C001
1000000C0000010011000000C0000010011000000C001
111111111111111111111111111111111111111111111