11111111111111111
10E10000000C10001
10001000000100001
101000000000P0001
10C10000000001001
1110000000000C101
1000000C000001001
11111111111111111