1111111
10P1001
1000C01
1000011
10000E1
1111111