1111111
1C01001
1000001
1000011
1111111