111111111111
100E00000001
100000000001
10000000P001
100C00000001
111111111111